{
  "gridWidth": 14,
  "gridHeight": 14,
  "surfaceRows": 2,
  "cellSize": 32,
  "gridOffset": {
    "x": 64,
    "y": 48
  },

  "grid": [
    [ 2, 2, 2, 2, 2, 2, 2, 2, 2, 2, 2, 2, 2, 2 ],
    [ 2, 2, 2, 2, 2, 2, 2, 2, 2, 2, 2, 2, 2, 2 ],
    [ 0, 0, 0, 0, 0, 0, 1, 1, 0, 0, 0, 0, 0, 0 ],
    [ 0, 0, 0, 0, 0, 0, 1, 1, 0, 0, 0, 0, 0, 0 ],
    [ 0, 0, 0, 0, 0, 0, 0, 0, 0, 0, 0, 0, 0, 0 ],
    [ 0, 0, 0, 1, 1, 1, 0, 0, 0, 0, 0, 0, 0, 0 ],
    [ 0, 0, 0, 1, 0, 1, 0, 0, 0, 1, 1, 0, 0, 0 ],
    [ 0, 0, 0, 0, 0, 0, 0, 0, 0, 1, 1, 0, 0, 0 ],
    [ 0, 0, 0, 0, 0, 0, 0, 0, 0, 0, 0, 0, 0, 0 ],
    [ 0, 0, 0, 0, 0, 0, 0, 0, 0, 0, 0, 0, 0, 0 ],
    [ 0, 0, 0, 0, 0, 0, 0, 0, 0, 0, 0, 0, 0, 0 ],
    [ 0, 0, 0, 0, 0, 0, 0, 0, 0, 0, 0, 0, 0, 0 ],
    [ 0, 0, 0, 0, 0, 0, 0, 0, 0, 0, 0, 0, 0, 0 ],
    [ 0, 0, 0, 0, 0, 0, 0, 0, 0, 0, 0, 0, 0, 0 ]
  ],

  "playerSpawn": {
    "x": 6,
    "y": 2
  },
  "player2Spawn": {
    "x": 8,
    "y": 2
  },

  "enemies": [
    {
      "type": "Pooka",
      "x": 3,
      "y": 5
    },
    {
      "type": "Pooka",
      "x": 5,
      "y": 5
    },
    {
      "type": "Pooka",
      "x": 9,
      "y": 6
    },
    {
      "type": "Fygar",
      "x": 10,
      "y": 6
    }
  ],

  "rocks": [
    {
      "x": 4,
      "y": 4
    },
    {
      "x": 10,
      "y": 5
    }
  ]
}